The final game of the Fifa World Cup 2014 has just finished. Italy has just beaten Brazil and all of the Italy fans are as happy as a kid in a candy shop and all that candy is free. As an Italy fan you are no exception and the body paint covering your head and torso seems to shine in the lights of the stadium. However the home fans can be categorized as nothing less than a furious angry mob. As the home fans start charging over to your side of the stadium you and the rest of the Italy fans start running for your lives. As you peer down at the field you can see the Italian soccer team also being chased down by a bunch of angry Brazilians and you can only hope that everyone is able to escape without injury. No matter how big this stadium is seeing that many people charging is a sight that would make any grown man tremble. After hiding in the bathroom for a little bit you walk out into the Concourse and see the angry mob of Brazilians running off into the street.

Viva L'Italia
An Interactive Fiction by Cody Martinson The Maximum score is 6
Release 1 / Serial number 140306 / Inform 7 build 6G60 (I6/v6.32 lib 6/12N) SD

Stadium Concourse
The stadium concourse, you can see the angry mob of Brazilians running off into the distance. Around you there are food kiosks and booths selling booster wear for Brazil, Italy, and FIFA. There's also a trashcan, recycle bin, and trash on the ground. There's a garage to the north of you.

You can see Bottles, FIFA Booster Wear, Brazil Booster Wear, Italy Booster Wear and Trash here.

I beg your pardon?

>n
Garage
The stadium garage. There are still tons of cars here, everyone must have just chosen to run instead of trying to drive off. You can see a fancy bus to the east of you and the street that runs behind the stadium to the west of you.

El Sharaawy arrives from the west.

* * *

>take brazil
You will not dirty your hands by touching that filth.

* * *

>take fifa
[Your score has just gone up by one point.]

>take italy
[Your score has just gone up by one point.]

>take brazil
That's fixed in place.

* * *

>north
Garage
The stadium garage. There are still tons of cars here, everyone must have just chosen to run instead of trying to drive off. You can see a fancy bus to the east of you and the street that runs behind the stadium to the west of you.

>east
Back Street

>west
Garage
The stadium garage. There are still tons of cars here, everyone must have just chosen to run instead of trying to drive off. You can see a fancy bus to the east of you and the street that runs behind the stadium to the west of you.

>w
Bus

>w
You can't go that way.

>w
You can't go that way.

* * *

>x El Sharaawt
You can't see any such thing.

>x El Sharaawy
You can't see any such thing.

* * *

>n
Garage
The stadium garage. There are still tons of cars here, everyone must have just chosen to run instead of trying to drive off. You can see a fancy bus to the east of you and the Garage door probably leading outside to the west of you.

You can see a Garage Door here.

>x cars
Cars of everyshape and size are everwhere in this massive parking garage. You don't have time to check all of them out though, who knows when those Brazilians could come back.

>enter ferrari
You can feel the power of this Italian sports car pulze through your veins as you get in. Luckily someone had left the keys in the cupholder so you power her up and drive off into the night, nobody can catch you now.

    *** You have won ***

In that game you scored 0 out of a possible 0, in 3 turns.

Would you like to RESTART, RESTORE a saved game, QUIT or UNDO the last command?

>undo
Garage
[Previous turn undone.]

>s
Stadium Concourse
The stadium concourse, you can see the angry mob of Brazilians running off into the distance. Around you there are food kiosks and booths selling booster wear for Brazil, Italy, and FIFA. There's also a trashcan, recycle bin, and trash on the ground. There's a garage to the north of you.

You can see Bottles, FIFA Booster Wear, Brazil Booster Wear, Italy Booster Wear and Trash here.

>take soda
You can't see any such thing.

>x recycle
A recycle bin, you can see bottles of different drinks inside. For some reason there seems to be an unopened can of soda inside the bin as well.

>take soda
You put the Sprite in your bag for later. You may need it more then.

>take italy
[Your score has just gone up by one point.]

>take fifa
[Your score has just gone up by one point.]

>n
Garage
The stadium garage. There are still tons of cars here, everyone must have just chosen to run instead of trying to drive off. You can see a fancy bus to the east of you and the Garage door probably leading outside to the west of you.

You can see a Garage Door and a Ferrari (empty) here.

>enter ferrari
You can feel the power of this Italian sports car pulze through your veins as you get in. Luckily someone had left the keys in the cupholder so you power her up and drive off into the night, nobody can catch you now.

    *** You have won ***

In that game you scored 2 out of a possible 0, in 9 turns.

Would you like to RESTART, RESTORE a saved game, QUIT or UNDO the last command?

* * *

>n
Garage
The stadium garage. There are still tons of cars here, everyone must have just chosen to run instead of trying to drive off. You can see a fancy bus to the east of you and the Garage door probably leading outside to the west of you.

You can see a Garage Door here.

>w
Bus
The Italian team's bus! Worried about the team you rush inside the bus to find it almost completely empty. As you move past the rows of comfortable seats you reach the back of the bus and find a pile of bags on the seats.

You can see a rows of seats (empty) and Bags here.

>take bags
As you move to take a closer look at the bags a man bursts from the pile and lands a solid kick to your abdomen. You stagger backwards and lift your arms to block yourself from another hit. As you get a better look at your assailant you gasp in surprise. It's El Sharaawy, your favorite player on the Italian team. As he realizes you're wearing Italian colors he rushes over to check on you. He explains that when the Brazil fans came charging the rest of the team ran but even though he was the fastest he knew hiding was a better option. You want to leave but you can't just leave him here alone. You have to take him with you but he's very adamant about staying. Time for you to do some fancy talking, maybe Asking him About coming with you would be helpful.

>take el
As you attempt to pull him out of the bus he does what any sensible person would do and starts flailing around. As one of his kicks flies toward your chest you make a last ditch effort to evade and end up falling out of the bus directly on your head.

    *** You have died ***

In that game you scored 0 out of a possible 0, in 4 turns.

Would you like to RESTART, RESTORE a saved game, QUIT or UNDO the last command?

>undo
Bus
[Previous turn undone.]

>ask el about come with me
He looks at you again and decides that you are a trustworthy looking person. "I'm counting on you to get us out of here," he says. Time for you to do your job.

>e
Garage
The stadium garage. There are still tons of cars here, everyone must have just chosen to run instead of trying to drive off. You can see a fancy bus to the east of you and the Garage door probably leading outside to the west of you.

You can see a Garage Door here.

>e
(first opening the Garage Door)
It seems to be locked.

>unlock door
(with the Bag)
That doesn't seem to fit the lock.

>with el
That's not a verb I recognise.

>unlock door with el
(first taking El Sharaawy)
As you attempt to pull him out of the bus he does what any sensible person would do and starts flailing around. As one of his kicks flies toward your chest you make a last ditch effort to evade and end up falling out of the bus directly on your head.

    *** You have died ***

In that game you scored 0 out of a possible 0, in 9 turns.

Would you like to RESTART, RESTORE a saved game, QUIT or UNDO the last command?

* * *

>ask El about come with me if you want to live
He looks at you in awe and picks himself off the bags. You begin to change into someone that looks like Arnold Schwarzenegger and you charge out of the bus, blazing a path in front of you with all the fires of hell.

    *** You have won ***

In that game you scored 0 out of a possible 0, in 4 turns.

Would you like to RESTART, RESTORE a saved game, QUIT or UNDO the last command?

* * *

>e
Garage
The stadium garage. There are still tons of cars here, everyone must have just chosen to run instead of trying to drive off. You can see a fancy bus to the east of you and the Garage door probably leading outside to the west of you.

You can see a Garage Door here.

* * *

>e
(first opening the Garage Door)
It seems to be locked.

>w
Bus
The Italian team's bus! Worried about the team you rush inside the bus to find it almost completely empty. As you move past the rows of comfortable seats you reach the back of the bus and find a pile of bags on the seats.

You can see El Sharaawy and Bags here.

>take el
I don't suppose El Sharaawy would care for that.

>ask el about come with me
He looks at you again and decides that you are a trustworthy looking person. "I'm counting on you to get us out of here," he says. Time for you to do your job.

>undo
Bus
[Previous turn undone.]

>ask el about come me
There is no reply.

* * *

>ask el about come with me
He looks at you again and decides that you are a trustworthy looking person. "I'm counting on you to get us out of here. You may need this," he says and hands you the key to the Garage Door. Time for you to do your job.

>e
Garage
The stadium garage. There are still tons of cars here, everyone must have just chosen to run instead of trying to drive off. You can see a fancy bus to the east of you and the Garage door probably leading outside to the west of you.

You can see a Garage Door here.

* * *

>e
(first opening the Garage Door)
It seems to be locked.

>unlock
What do you want to unlock?

>garage door
What do you want to unlock the Garage Door with?

>card
You unlock the Garage Door.

>e
(first opening the Garage Door)

Back Street
A dingy back street, unfitting of the World Cup. By the dim light of the one lamp post you can see multiple trash cans and trash bags lying around. Off in the distance you can hear the Brazillians yelling to each other.

You can see a Garage Door and Trash Cans here.

>w
Garage
The stadium garage. There are still tons of cars here, everyone must have just chosen to run instead of trying to drive off. You can see a fancy bus to the east of you and the Garage door probably leading outside to the west of you.

You can see a Garage Door here.

>e
Back Street
A dingy back street, unfitting of the World Cup. By the dim light of the one lamp post you can see multiple trash cans and trash bags lying around. Off in the distance you can hear the Brazillians yelling to each other.

You can see a Garage Door and Trash Cans here.

>n
Hotel

>n
You can't go that way.

>w
Park
You can see a Gas Can here.

>e
Hotel

>up
Hotel Room

>d
Hotel

>w
Park
You can see a Gas Can here.

>w
Harbor
You can see a Gasless Boat (empty) here.

>e
Park
You can see a Gas Can here.

>take gas
Taken.

>w
Harbor
You can see a Gasless Boat (empty) here.

* * *

>e
(first opening the Garage Door)
It seems to be locked.

>unlock door
What do you want to unlock the Garage Door key with?

>garage door key
I didn't understand that sentence.

>unlock garage door with garage door key
(the Garage Door key with the Garage Door key)
That doesn't seem to be something you can unlock.

>x garage door
(the Garage Door key)
The card key that unlocks the Garage door.

* * *

>w
Bus
The Italian team's bus! Worried about the team you rush inside the bus to find it almost completely empty. As you move past the rows of comfortable seats you reach the back of the bus and find a pile of bags on the seats.

You can see a rows of seats (empty) and Bags here.

>x el
Your favorite soccer player in the world. Not only is he super fast but he has a sick mohawk.

>x sharaawy
Your favorite soccer player in the world. Not only is he super fast but he has a sick mohawk.

>x el
Your favorite soccer player in the world. Not only is he super fast but he has a sick mohawk.

>x el
Your favorite soccer player in the world. Not only is he super fast but he has a sick mohawk.

>x el sharaawy
Your favorite soccer player in the world. Not only is he super fast but he has a sick mohawk.

>x el
Your favorite soccer player in the world. Not only is he super fast but he has a sick mohawk.

* * *

>w
Bus
The Italian team's bus! Worried about the team you rush inside the bus to find it almost completely empty. As you move past the rows of comfortable seats you reach the back of the bus and find a pile of bags on the seats.

You can see a rows of seats (empty) and Bags here.

>take bag
You already have that.

>take bags
As you move to take a closer look at the bags a man bursts from the pile and lands a solid kick to your abdomen. You stagger backwards and lift your arms to block yourself from another hit. As you get a better look at your assailant you gasp in surprise. It's El Sharaawy, your favorite player on the Italian team. As he realizes you're wearing Italian colors he rushes over to check on you. He explains that when the Brazil fans came charging the rest of the team ran but even though he was the fastest he knew hiding was a better option. You want to leave but you can't just leave him here alone. You have to take him with you but he's very adamant about staying. Time for you to do some fancy talking, maybe Asking him About coming with you would be helpful.

* * *

>e
(first opening the Garage Door)
It seems to be locked.

>unlock with card
You can't see any such thing.

>unlock door with card
You unlock the Garage Door.

>e
(first opening the Garage Door)

Back Street
A dingy back street, unfitting of the World Cup. By the dim light of the one lamp post you can see multiple trash cans and trash bags lying around. Off in the distance you can hear the Brazillians yelling to each other.

You can see a Garage Door and Trash Cans here.

>n
Hotel

* * *

>w
Harbor
You can see a Gasless Boat (empty) here.

>take boat
You move the Boat a few feet before realizing it's way to heavy to carry. You decide to drag it along behind you though, just so no one else steals your boat.

* * *

>n
Garage
The stadium garage. There are still tons of cars here, everyone must have just chosen to run instead of trying to drive off. You can see a fancy bus to the east of you and the Garage door probably leading outside to the west of you.

You can see a Garage Door here.

>x car right next to you
Cars of everyshape and size are everwhere in this massive parking garage. You don't have time to check all of them out though, who knows when those Brazilians could come back.

>enter ferrari
You can feel the power of this Italian sports car pulze through your veins as you get in. Luckily someone had left the keys in the cupholder so you power her up and drive off into the night, nobody can catch you now.

    *** You have won ***

In that game you scored 0 out of a possible 0, in 3 turns.

Would you like to RESTART, RESTORE a saved game, QUIT or UNDO the last command?

* * *

>n
Garage
The stadium garage. There are still tons of cars here, everyone must have just chosen to run instead of trying to drive off. You can see a fancy bus to the east of you and the Garage door probably leading outside to the west of you.

You can see a Garage Door here.

>e
(first opening the Garage Door)
It seems to be locked.

>w
Bus
The Italian team's bus! Worried about the team you rush inside the bus to find it almost completely empty. As you move past the rows of comfortable seats you reach the back of the bus and find a pile of bags on the seats.

You can see Bags here.

>e
Back Street
A dingy back street, unfitting of the World Cup. By the dim light of the one lamp post you can see multiple trash cans and trash bags lying around.

El Sharaawy arrives from the west.

I beg your pardon?

* * *

I beg your pardon?

>w
Garage
The stadium garage. There are still tons of cars here, everyone must have just chosen to run instead of trying to drive off. You can see a fancy bus to the east of you and the street that runs behind the stadium to the west of you.

El Sharaawy arrives from the east.

>e
Back Street
A dingy back street, unfitting of the World Cup. By the dim light of the one lamp post you can see multiple trash cans and trash bags lying around.

"We better move quietly", El Sharaawy says.

El Sharaawy arrives from the west.

>n
Hotel
El Sharaawy arrives from the south.

>w
Park
El Sharaawy arrives from the east.

>w
Harbor
You can see a boat (empty) here.

El Sharaawy arrives from the east.

>enter boat
You get into the boat.

>g
But you're already in the boat.

>n
You can't go that way.

I beg your pardon?

>w
You can't go that way.

>e
Park (in the boat)
El Sharaawy arrives from the west.

>e
Hotel (in the boat)
El Sharaawy arrives from the west.

* * *

>w
Bus
The Italian team's bus! Worried about the team you rush inside the bus to find it almost completely empty. As you move past the rows of comfortable seats you reach the back of the bus and find a pile of bags on the seats.

You can see Bags here.

>x bags
It looks to be the team's gear.

>take bags
As you move to take a closer look at the bags a man bursts from the pile and lands a solid kick to your abdomen. You stagger backwards and lift your arms to block yourself from another hit. As you get a better look at your assailant you gasp in surprise. It's El Sharaawy, your favorite player on the entire Italian team. As he realizes you're wearing Italian colors he rushes over to check on you. He explains that when the Brazil fans came charging the rest of the team ran but even though he was the fastest he knew hiding was a better option. You can't just leave him here alone. You have to take him with you but he's very adamant about staying. Time for you to do some fancy talking.

* * *

>w
You can't go that way.

>w
You can't go that way.

El Sharaawy arrives from the north.

>w
You can't go that way.

"We better move quietly", El Sharaawy says.

>w
You can't go that way.

>n
Garage
The stadium garage. There are still tons of cars here, everyone must have just chosen to run instead of trying to drive off. You can see a fancy bus to the east of you and the street that runs behind the stadium to the west of you.

El Sharaawy arrives from the south.

>m
That's not a verb I recognise.

>k
That's not a verb I recognise.

>l
Garage
The stadium garage. There are still tons of cars here, everyone must have just chosen to run instead of trying to drive off. You can see a fancy bus to the east of you and the street that runs behind the stadium to the west of you.

You can see El Sharaawy here.

>o
Sorry, that can't be corrected.

>r
That's not a verb I recognise.

>s
Stadium Concourse
The stadium concourse, you can see the angry mob of Brazillians running off into the distance. Around you there are food kiosks and booths selling booster wear for Brazil, Italy, and FIFA. There's also a trashcan, recycle bin, and trash on the ground. There's a garage to the north of you.

You can see Bottles, FIFA Booster Wear, Brazil Booster Wear, Italy Booster Wear and Trash here.

El Sharaawy arrives from the north.

>n
Garage
The stadium garage. There are still tons of cars here, everyone must have just chosen to run instead of trying to drive off. You can see a fancy bus to the east of you and the street that runs behind the stadium to the west of you.

El Sharaawy arrives from the south.

>w
Bus
The Italian team's bus! Worried about the team you rush inside the bus to find it almost completely empty. As you move past the rows of comfortable seats you reach the back of the bus and find a pile of bags on the seats.

You can see Bags here.

El Sharaawy arrives from the east.

>e
Garage
The stadium garage. There are still tons of cars here, everyone must have just chosen to run instead of trying to drive off. You can see a fancy bus to the east of you and the street that runs behind the stadium to the west of you.

El Sharaawy arrives from the west.

>r
That's not a verb I recognise.

>d
You can't go that way.

"We better move quietly", El Sharaawy says.

I beg your pardon?

>u
You can't go that way.

>u
You can't go that way.

I beg your pardon?

>s
Stadium Concourse
The stadium concourse, you can see the angry mob of Brazillians running off into the distance. Around you there are food kiosks and booths selling booster wear for Brazil, Italy, and FIFA. There's also a trashcan, recycle bin, and trash on the ground. There's a garage to the north of you.

You can see Bottles, FIFA Booster Wear, Brazil Booster Wear, Italy Booster Wear and Trash here.

El Sharaawy arrives from the north.

>x
(the Bag)
An Italy booster bag, why would you have anything else. Everything you take will end up in here so there's no need to carry all that wierd stuff.

>x
(the Bag)
An Italy booster bag, why would you have anything else. Everything you take will end up in here so there's no need to carry all that wierd stuff.

>x
(the Bag)
An Italy booster bag, why would you have anything else. Everything you take will end up in here so there's no need to carry all that wierd stuff.

"We better move quietly", El Sharaawy says.

>x
(the Bag)
An Italy booster bag, why would you have anything else. Everything you take will end up in here so there's no need to carry all that wierd stuff.

* * *

>w
You can't go that way.

>n
Garage
The stadium garage. There are still tons of cars here, everyone must have just chosen to run instead of trying to drive off. You can see a fancy bus to the east of you and the street that runs behind the stadium to the west of you.

>w
Bus
The Italian team's bus! Worried about the team you rush inside the bus to find it almost completely empty. As you move past the rows of comfortable seats you reach the back of the bus and find a pile of bags on the seats.

You can see Bags here.

>take bags
As you move to take a closer look at the bags a man bursts from the pile and lands a solid kick to your abdomen. You stagger backwards and lift your arms to block yourself from another hit. As you get a better look at your assailant you gasp in surprise. It's El Sharaawy, your favorite player on the entire Italian team. As he realizes you're wearing Italian colors he rushes over to check on you. He explains that when the Brazil fans came charging the rest of the team ran but even though he was the fastest he knew hiding was a better option. You can't just leave him here alone. You have to take him with you but he's very adamant about staying. Time for you to do some fancy talking.

* * *

>s
You can't go that way.

I beg your pardon?

>w
You can't go that way.

"We better move quietly", El Sharaawy says.

El Sharaawy arrives from the north.

>e
You can't go that way.

>q
Are you sure you want to quit?

>r
Please answer yes or no.

Please answer yes or no.

Please answer yes or no.