The final game of the Fifa World Cup 2014 has just finished. Italy has just beaten Brazil and all of the Italy fans are as happy as a kid in a candy shop and all that candy is free. As an Italy fan you are no exception and the body paint covering your head and torso seems to shine in the lights of the stadium. However the home fans can be categorized as nothing less than a furious angry mob. As the home fans start charging over to your side of the stadium you and the rest of the Italy fans start running for your lives. As you peer down at the field you can see the Italian soccer team also being chased down by a bunch of angry Brazilians and you can only hope that everyone is able to escape without injury. No matter how big this stadium is seeing that many people charging is a sight that would make any grown man tremble. After hiding in the bathroom for a little bit you walk out into the Concourse and see the angry mob of Brazilians running off into the street. You need to find a way out of the country or else who knows what will happen to you.

Viva L'Italia
An Interactive Fiction by Cody Martinson
Release 1 / Serial number 140311 / Inform 7 build 6G60 (I6/v6.32 lib 6/12N) SD

Stadium Concourse
The stadium concourse, you can see the angry mob of Brazilians running off into the distance. Around you there are food kiosks and booths selling booster wear for Brazil, Italy, and FIFA. There's also a trashcan, recycle bin, and trash on the ground. There's a garage to the north of you.

You can see Food, Bottles, FIFA Booster Wear, Brazil Booster Wear, Italy Booster Wear and Trash here.

I beg your pardon?

>n
Garage
The stadium garage. There are still tons of cars here, everyone must have just chosen to run instead of trying to drive off. You can see a fancy bus to the west of you and the Garage door probably leading outside to the east of you.

You can see a Garage Door here.

>w
Bus
The Italian team's bus! Worried about the team you rush inside the bus to find it almost completely empty. As you move past the rows of comfortable seats you reach the back of the bus and find a pile of bags on the seats. The garage is to the east of you.

You can see a rows of seats (empty) and Bags here.

>take bags
As you move to take a closer look at the bags a man bursts from the pile and lands a solid kick to your abdomen. You stagger backwards and lift your arms to block yourself from another hit. As you get a better look at your assailant you gasp in surprise. It's El Sharaawy, your favorite player on the Italian team. As he realizes you're wearing Italian colors he rushes over to check on you. He explains that when the Brazil fans came charging the rest of the team ran but even though he was the fastest he knew hiding was a better option. You want to leave but you can't just leave him here alone. You have to take him with you but he's very adamant about staying. Time for you to do some fancy talking, maybe Asking him About coming with you would be helpful.

>take bags
You already have that.

>ask el about come with me
He looks at you again and decides that you are a trustworthy looking person. "I'm counting on you to get us out of here. You may need this," he says and hands you the key to the Garage Door. Time for you to do your job.

[Your score has just gone up by one point.]

>me
That's not a verb I recognise.

>x me
Decked out in full Italy body paint. Your face and torso are covered in the traditional green, white, and red. You have your hair in a mohawk like El Sharaawy, your favorite player. You might wanna stay as hidden as possible if you don't wanna get caught.

>n
You can't go that way.

>w
You can't go that way.

I beg your pardon?

>e
Garage
The stadium garage. There are still tons of cars here, everyone must have just chosen to run instead of trying to drive off. You can see a fancy bus to the west of you and the Garage door probably leading outside to the east of you.

You can see a Garage Door here.

>e
(first opening the Garage Door)
It seems to be locked.

>unlock door with key
You unlock the Garage Door.

>e
(first opening the Garage Door)

Back Street
A dingy back street, unfitting of the World Cup. By the dim light of the one lamp post you can see multiple trash cans and trash bags lying around. Off in the distance you can hear the Brazillians yelling to each other. More descriptions later.

You can see a Garage Door, Trash Cans, Cigarette butts and Bottles of Alcohol here.

I beg your pardon?

>n
Hotel
The hotel you're staying at, you have a room in one of the floors above. You can see a few Brazilians walking around patroling for Italian supporters like you before they move on, leaving one man to keep watch. You should think this through very carefully before making a move. Or not, but getting to your room would guarantee you some useful stuff. You can see a park to the west of you and the street you just came off of to the east.

You can see a Brazilian here.

An exclamation pops up on the top of the Brazilian's heads as they rush toward you.

    *** You have died ***

In that game you scored 1 out of a possible 0, in 13 turns.

Would you like to RESTART, RESTORE a saved game, QUIT or UNDO the last command?

>s
Please give one of the answers above.

Would you like to RESTART, RESTORE a saved game, QUIT or UNDO the last command?

>undo
Back Street
[Previous turn undone.]

>x trash cans
Looking into the nearest two trash cans you find nothing but trash, what a surprise, but after looking in the third you pull out a vaccum sealed bag with two sets of Grey Fatigues inside like something out of Metal Gear. You give one to El Sharaawy and put yours on.

>n
Hotel
The hotel you're staying at, you have a room in one of the floors above. You can see a few Brazilians walking around patroling for Italian supporters like you before they move on, leaving one man to keep watch. You should think this through very carefully before making a move. Or not, but getting to your room would guarantee you some useful stuff. You can see a park to the west of you and the street you just came off of to the east.

You can see a Brazilian here.

You move quietly around the Hotel Lobby to not be noticed

>w
Park
A park. It's quiet and peaceful with not a single angry mob in sight. The leaves on the trees rustle in a peaceful manner, very different from how the rest of your night has been. There's a gas can on the ground which is odd, I mean seriously, it's a gas can in the middle of a park. There looks to be a harbor to the west of you and the hotel to your east..

You can see a Gas Can here.

>w
Harbor
The harbor you can see the American ship a way off into the difference. It's to far to swim but you see a boat on the beach next to you. As you move toward the boat your hope grows and El Sharaawy sprints towards it. As you reach it you find that there is a major problem, it has no gas. The park is to the east of you. More descriptions coming later. You should probably try combining something with the boat. The part is to the east.

You can see a Gasless Boat (empty) here.

* * *

>take all
There are none at all available!

* * *

>x mob
The home fans" "little mob". Who are you kidding, that things huge. It looks like every Brazil fan in the stadium joined to make that mob.

>n
Garage
The stadium garage. There are still tons of cars here, everyone must have just chosen to run instead of trying to drive off. You can see a fancy bus to the west of you and the Garage door probably leading outside to the east of you.

You can see a Garage Door here.

* * *

>ask him about come with me
I'm not sure what "him" refers to.

>ask el about come with me
He looks at you again and decides that you are a trustworthy looking person. "I'm counting on you to get us out of here. You may need this," he says and hands you the key to the Garage Door. Time for you to do your job.

[Your score has just gone up by one point.]

>s
You can't go that way.

>w
You can't go that way.

>e
Garage
The stadium garage. There are still tons of cars here, everyone must have just chosen to run instead of trying to drive off. You can see a fancy bus to the west of you and the Garage door probably leading outside to the east of you.

You can see a Garage Door here.

I beg your pardon?

>e
(first opening the Garage Door)
It seems to be locked.

* * *

>unlock door with key
You unlock the Garage Door.

>e
(first opening the Garage Door)

Back Street
A dingy back street, unfitting of the World Cup. By the dim light of the one lamp post you can see multiple trash cans and trash bags lying around. Off in the distance you can hear the Brazillians yelling to each other. The Hotel is to your north and the garage is to the west.

You can see a Garage Door, Trash Cans, Cigarette butts and Bottles of Alcohol here.

>x casn
You can't see any such thing.

>x cans
Looking into the nearest two trash cans you find nothing but trash, what a surprise, but after looking in the third you pull out a vaccum sealed bag with two sets of Grey Fatigues inside like something out of Metal Gear. You give one to El Sharaawy and put yours on.

>n
Hotel Lobby
The hotel you're staying at, you have a room in one of the floors above. You can see a few Brazilians walking around patroling for Italian supporters like you before they move on, leaving one man to keep watch. You should think this through very carefully before making a move. Or not, but getting to your room would guarantee you some useful stuff. There is a bench, a computer, and some potted plants in the Hotel Lobby. You can see a park to the west of you and the street you just came off of to the east. Your room is above you.

You can see a Brazilian, a bench (empty), a potted plants and a computer here.

You move quietly around the Hotel Lobby to not be noticed

>w
Park
A park. It's quiet and peaceful with not a single angry mob in sight. The leaves on the trees rustle in a peaceful manner, very different from how the rest of your night has been. There's a gas can on the ground which is odd, I mean seriously, it's a gas can in the middle of a park. There looks to be a harbor to the west of you and the hotel is to your east.

You can see a Gas Can, Trees and Leaves here.

I beg your pardon?

* * *

>x me
Decked out in full Italy body paint. Your face and torso are covered in the traditional green, white, and red. You have your hair in a mohawk like El Sharaawy, your favorite player. You might wanna stay as hidden as possible if you don't wanna get caught.

>x bottles
Empty sticky bottles of drinks.

>x booster wear
Which do you mean, FIFA Booster Wear, Brazil Booster Wear or Italy Booster Wear?

>x fifa booster wear
FIFA booster wear that they're selling. Most of it is just clothes advertising the fact that it's the FIFA World Cup. There are some nice shirts in there though.

>x brazil booster wear
Disgusting, dirty Brazilian Booster Wear. You'd burn it but you don't have the time or tools to do that.

>x italy booster wear
Beautiful, amazing Italian Booster Wear. You can never have to much of this.

>x trash
Scraps of paper dishes, paper pamphlets, and other bits of trash litter the ground.

>take all
Bottles: FIFA Booster Wear: Italy Booster Wear: Trash: Taken.

[Your score has just gone up by three points.]

>x trash can
I only understood you as far as wanting to examine Trash.

>put bottles in recycle bin
That can't contain things.

>put trash in trashcan
That can't contain things.

>north
Garage
The stadium garage. There are still tons of cars here, everyone must have just chosen to run instead of trying to drive off. You can see a fancy bus to the east of you and the Garage door probably leading outside to the west of you. More descriptions later.

You can see a Garage Door here.

>take car
That's hardly portable.

>x bus
A fancy bus, looks like it belongs to one of the soccer teams. You should probably go east if you want to examine it more.

>east
(first opening the Garage Door)
It seems to be locked.

>west
Bus
The Italian team's bus! Worried about the team you rush inside the bus to find it almost completely empty. As you move past the rows of comfortable seats you reach the back of the bus and find a pile of bags on the seats.

You can see a rows of seats (empty) and Bags here.

>x bags
It looks to be the team's gear.

>open bags
That's not something you can open.

>take bags
As you move to take a closer look at the bags a man bursts from the pile and lands a solid kick to your abdomen. You stagger backwards and lift your arms to block yourself from another hit. As you get a better look at your assailant you gasp in surprise. It's El Sharaawy, your favorite player on the Italian team. As he realizes you're wearing Italian colors he rushes over to check on you. He explains that when the Brazil fans came charging the rest of the team ran but even though he was the fastest he knew hiding was a better option. You want to leave but you can't just leave him here alone. You have to take him with you but he's very adamant about staying. Time for you to do some fancy talking, maybe Asking him About coming with you would be helpful.

>x seats
Rows and rows of super comfy looking chairs but there ain't no way you're going to sit in one. Who knows if a Brazilian is hiding under one waiting to drag you down.

>look under seats
You find nothing of interest.

>open seats
That's not something you can open.

>take el sharaawy
As you attempt to pull him out of the bus he does what any sensible person would do and starts flailing around. As one of his kicks flies toward your chest you make a last ditch effort to evade and end up falling down directly on your head.

    *** You have died ***

In that game you scored 3 out of a possible 0, in 21 turns.

Would you like to RESTART, RESTORE a saved game, QUIT or UNDO the last command?

>undo
Bus
[Previous turn undone.]

>ask el to come with me
I didn't understand that sentence.

>ask el to come
I didn't understand that sentence.

>ask el about coming with me
There is no reply.

>ask el about coming
There is no reply.

>ask el about following
There is no reply.

>ask el about leaving
There is no reply.

>ask el about coming with me
There is no reply.

>talk to el
That's not a verb I recognise.

>talk with el
That's not a verb I recognise.

>tell el to come
I didn't understand that sentence.

>ask el coming
I didn't understand that sentence.

>ask el about come
There is no reply.

>ask el about come with me
He looks at you again and decides that you are a trustworthy looking person. "I'm counting on you to get us out of here. You may need this," he says and hands you the key to the Garage Door. Time for you to do your job.

>l
Bus
The Italian team's bus! Worried about the team you rush inside the bus to find it almost completely empty. As you move past the rows of comfortable seats you reach the back of the bus and find a pile of bags on the seats.

You can see El Sharaawy, a rows of seats (empty) and Bags here.

>take bags
As you move to take a closer look at the bags a man bursts from the pile and lands a solid kick to your abdomen. You stagger backwards and lift your arms to block yourself from another hit. As you get a better look at your assailant you gasp in surprise. It's El Sharaawy, your favorite player on the Italian team. As he realizes you're wearing Italian colors he rushes over to check on you. He explains that when the Brazil fans came charging the rest of the team ran but even though he was the fastest he knew hiding was a better option. You want to leave but you can't just leave him here alone. You have to take him with you but he's very adamant about staying. Time for you to do some fancy talking, maybe Asking him About coming with you would be helpful.

>put bags in seats
(first taking Bags)

As you move to take a closer look at the bags a man bursts from the pile and lands a solid kick to your abdomen. You stagger backwards and lift your arms to block yourself from another hit. As you get a better look at your assailant you gasp in surprise. It's El Sharaawy, your favorite player on the Italian team. As he realizes you're wearing Italian colors he rushes over to check on you. He explains that when the Brazil fans came charging the rest of the team ran but even though he was the fastest he knew hiding was a better option. You want to leave but you can't just leave him here alone. You have to take him with you but he's very adamant about staying. Time for you to do some fancy talking, maybe Asking him About coming with you would be helpful.

>west
You can't go that way.

>east
Garage
The stadium garage. There are still tons of cars here, everyone must have just chosen to run instead of trying to drive off. You can see a fancy bus to the east of you and the Garage door probably leading outside to the west of you. More descriptions later.

You can see a Garage Door here.

>unlock garage door with key
You unlock the Garage Door.

>open door
You open the Garage Door.

>east
Back Street
A dingy back street, unfitting of the World Cup. By the dim light of the one lamp post you can see multiple trash cans and trash bags lying around. Off in the distance you can hear the Brazillians yelling to each other. More descriptions later.

You can see a Garage Door, Trash Cans, Cigarette butts and Bottles of Alcohol here.

>x trash cans
Looking into the nearest two trash cans you find nothing but trash, what a surprise, but after looking in the third you pull out a vaccum sealed bag with two sets of Grey Fatigues inside like something out of Metal Gear. You give one to El Sharaawy and put yours on.

>x cigarettes
Dirty cigarette butts, you can smell the cancer rolling off of each seperate one.

>x alcohol
Alcohol, not good for the kiddies at the tournament but it's fine for adults. You probably shouldn't drink it right now though, who knows if you'll need it later.

>take all
Bottles of Alcohol: El Sharaawy's Fatigues: That seems to belong to El Sharaawy.

[Your score has just gone up by one point.]

>smoke cigarette
That's not a verb I recognise.

>drink alcohol
There's nothing suitable to drink here.

>north
Hotel
The hotel you're staying at, you have a room in one of the floors above. You can see a few Brazilians walking around patroling for Italian supporters like you before they move on, leaving one man to keep watch. You should think this through very carefully before making a move. Or not, but getting to your room would guarantee you some useful stuff. You can see a park to the west of you and the street you just came off of to the east. More descriptions later.

You can see a Brazilian here.

You move quietly around the Hotel Lobby to not be noticed

>l
Hotel
The hotel you're staying at, you have a room in one of the floors above. You can see a few Brazilians walking around patroling for Italian supporters like you before they move on, leaving one man to keep watch. You should think this through very carefully before making a move. Or not, but getting to your room would guarantee you some useful stuff. You can see a park to the west of you and the street you just came off of to the east. More descriptions later.

You can see El Sharaawy and a Brazilian here.

You move quietly around the Hotel Lobby to not be noticed

>talk to the brazilian
That's not a verb I recognise.

>ask brazilian about game
There is no reply.

You move quietly around the Hotel Lobby to not be noticed

>north
You can't go that way.

You move quietly around the Hotel Lobby to not be noticed

>up
Hotel Room
Your hotel room, all of your luggage is here but you should probably only take what you need. As you look out the ocean view window you can see an American battleship off the coast. If you made it to that ship you would probably be safe from these mad Brazilians. More descriptions later.

>x luggage
You can't see any such thing.

>down
Hotel
The hotel you're staying at, you have a room in one of the floors above. You can see a few Brazilians walking around patroling for Italian supporters like you before they move on, leaving one man to keep watch. You should think this through very carefully before making a move. Or not, but getting to your room would guarantee you some useful stuff. You can see a park to the west of you and the street you just came off of to the east. More descriptions later.

You can see a Brazilian here.

You move quietly around the Hotel Lobby to not be noticed

>take of italian paint
I only understood you as far as wanting to take Bottles of Alcohol.

>take off paint
You can't see any such thing.

>x me
Decked out in full Italy body paint. Your face and torso are covered in the traditional green, white, and red. You have your hair in a mohawk like El Sharaawy, your favorite player. You might wanna stay as hidden as possible if you don't wanna get caught.

You move quietly around the Hotel Lobby to not be noticed

>east
You can't go that way.

You move quietly around the Hotel Lobby to not be noticed

>south
Back Street
A dingy back street, unfitting of the World Cup. By the dim light of the one lamp post you can see multiple trash cans and trash bags lying around. Off in the distance you can hear the Brazillians yelling to each other. More descriptions later.

You can see a Garage Door, Trash Cans and Cigarette butts here.

>east
You can't go that way.

>wes
That's not a verb I recognise.

>w
Garage
The stadium garage. There are still tons of cars here, everyone must have just chosen to run instead of trying to drive off. You can see a fancy bus to the east of you and the Garage door probably leading outside to the west of you. More descriptions later.

You can see a Garage Door here.

>e
Back Street
A dingy back street, unfitting of the World Cup. By the dim light of the one lamp post you can see multiple trash cans and trash bags lying around. Off in the distance you can hear the Brazillians yelling to each other. More descriptions later.

You can see a Garage Door, Trash Cans and Cigarette butts here.

>s
You can't go that way.

>u
You can't go that way.

>d
You can't go that way.

>n
Hotel
The hotel you're staying at, you have a room in one of the floors above. You can see a few Brazilians walking around patroling for Italian supporters like you before they move on, leaving one man to keep watch. You should think this through very carefully before making a move. Or not, but getting to your room would guarantee you some useful stuff. You can see a park to the west of you and the street you just came off of to the east. More descriptions later.

You can see a Brazilian here.

You move quietly around the Hotel Lobby to not be noticed

>west
Park
A park. More descriptions coming later.

You can see a Gas Can here.

>x gas can
A can of gas, you may need this later on to Combine With something.

>take gas
Taken.

>north
You can't go that way.

>south
You can't go that way.

>west
Harbor
The harbor you can see the American ship a way off into the difference. It's to far to swim but you see a boat on the beach next to you. As you move toward the boat your hope grows and El Sharaawy sprints towards it. As you reach it you find that there is a major problem, it has no gas. The park is to the east of you. More descriptions coming later.

You can see a Gasless Boat (empty) here.

* * *

>north
You can't go that way.

* * *

>south
You can't go that way.

>west
You can't go that way.

>up
You can't go that way.

>down
You can't go that way.

>drive
That's not a verb I recognise.

>drive boat
That's not a verb I recognise.

>turn on boat
That's not something you can switch.

>x boat
A boat that looks like it needs some gas.

>give boat gas
You can only do that to something animate.

>combine boat with gas
You fill up the boat with

>x boat
A boat that looks like it needs some gas.

>combine boat with gas
You can't see any such thing.

>i
You are carrying:
  Bottles of Alcohol
  your Fatigues
  a Card key
  Trash
  Italy Booster Wear
  FIFA Booster Wear
  Bottles
  a Bag

>put card key in boat
You put the Card key into the Gasless Boat.

>drive boat
That's not a verb I recognise.

>move boat
It is fixed in place.

>run boat
You get into the Gasless Boat.

In the Gasless Boat you can see a Card key.

    *** You have won ***

In that game you scored 4 out of a possible 0, in 76 turns.

Would you like to RESTART, RESTORE a saved game, QUIT or UNDO the last command?

* * *

>n
Garage
The stadium garage. There are still tons of cars here, everyone must have just chosen to run instead of trying to drive off. You can see a fancy bus to the west of you and the Garage door probably leading outside to the east of you.

You can see a Garage Door here.

>x cars
Cars of everyshape and size are everwhere in this massive parking garage. You don't have time to check all of them out though, who knows when those Brazilians could come back.

>l
Garage
The stadium garage. There are still tons of cars here, everyone must have just chosen to run instead of trying to drive off. You can see a fancy bus to the west of you and the Garage door probably leading outside to the east of you.

You can see a Garage Door here.

>x ferrari
You can't see any such thing.

>get in ferrari
You can't see any such thing.

>x cars
Cars of everyshape and size are everwhere in this massive parking garage. You don't have time to check all of them out though, who knows when those Brazilians could come back.

>x car right next to you
Cars of everyshape and size are everwhere in this massive parking garage. You don't have time to check all of them out though, who knows when those Brazilians could come back.

>l
Garage
The stadium garage. There are still tons of cars here, everyone must have just chosen to run instead of trying to drive off. You can see a fancy bus to the west of you and the Garage door probably leading outside to the east of you.

You can see a Ferrari (empty) and a Garage Door here.

>w
Bus
The Italian team's bus! Worried about the team you rush inside the bus to find it almost completely empty. As you move past the rows of comfortable seats you reach the back of the bus and find a pile of bags on the seats. The garage is to the east of you.

You can see a rows of seats (empty) and Bags here.

* * *

>ask el about come with me if you want to live
He looks at you in awe and picks himself off the bags. You begin to change into someone that looks like Arnold Schwarzenegger and you charge out of the bus, blazing a path in front of you with all the fires of hell.

    *** You have won ***

In that game you scored 0 out of a possible 0, in 9 turns.

Would you like to RESTART, RESTORE a saved game, QUIT or UNDO the last command?

* * *

>w
Bus
The Italian team's bus! Worried about the team you rush inside the bus to find it almost completely empty. As you move past the rows of comfortable seats you reach the back of the bus and find a pile of bags on the seats. The garage is to the east of you.

You can see a rows of seats (empty) and Bags here.

>sit in seats
(the rows of seats)
[Your score has just gone up by one point.]

>take bags
As you move to take a closer look at the bags a man bursts from the pile and lands a solid kick to your abdomen. You stagger backwards and lift your arms to block yourself from another hit. As you get a better look at your assailant you gasp in surprise. It's El Sharaawy, your favorite player on the Italian team. As he realizes you're wearing Italian colors he rushes over to check on you. He explains that when the Brazil fans came charging the rest of the team ran but even though he was the fastest he knew hiding was a better option. You want to leave but you can't just leave him here alone. You have to take him with you but he's very adamant about staying. Time for you to do some fancy talking, maybe Asking him About coming with you would be helpful.

>n
You'll have to get out of the rows of seats first.

>get off of seats
But you aren't on the rows of seats at the moment.

>get out of seats
I only understood you as far as wanting to get outside.

>s
You'll have to get out of the rows of seats first.

>w
You'll have to get out of the rows of seats first.

>e
You'll have to get out of the rows of seats first.

>f
That's not a verb I recognise.

>e
You'll have to get out of the rows of seats first.

I beg your pardon?

I beg your pardon?

* * *

>ask el about come with me
He looks at you again and decides that you are a trustworthy looking person. "I'm counting on you to get us out of here. You may need this," he says and hands you the key to the Garage Door. Time for you to do your job.

[Your score has just gone up by one point.]

>e
Garage
The stadium garage. There are still tons of cars here, everyone must have just chosen to run instead of trying to drive off. You can see a fancy bus to the west of you and the Garage door probably leading outside to the east of you.

You can see a Garage Door here.

* * *

>e
(first opening the Garage Door)
It seems to be locked.

>undo
Garage
[Previous turn undone.]

>unlock door with key
You unlock the Garage Door.

* * *

>e
(first opening the Garage Door)

Back Street
A dingy back street, unfitting of the World Cup. By the dim light of the one lamp post you can see multiple trash cans and trash bags lying around. Off in the distance you can hear the Brazillians yelling to each other. The Hotel is to your north and the garage is to the west.

You can see a Garage Door, Trash Cans, Cigarette butts and Bottles of Alcohol here.

>x trashcna
You can't see any such thing.

>x trashcans
You can't see any such thing.

>x trash cans
Looking into the nearest two trash cans you find nothing but trash, what a surprise, but after looking in the third you pull out a vaccum sealed bag with two sets of Grey Fatigues inside like something out of Metal Gear. You give one to El Sharaawy and put yours on.

>n
Hotel Lobby
The hotel you're staying at, you have a room in one of the floors above. You can see a few Brazilians walking around patroling for Italian supporters like you before they move on, leaving one man to keep watch. You should think this through very carefully before making a move. Or not, but getting to your room would guarantee you some useful stuff. There is a bench, a computer, and some potted plants in the Hotel Lobby. You can see a park to the west of you and the street you just came off of to the east. Your room is above you.

You can see a Brazilian, a bench (empty), a potted plants and a computer here.

You move quietly around the Hotel Lobby to not be noticed

* * *

>w
Park
A park. It's quiet and peaceful with not a single angry mob in sight. The leaves on the trees rustle in a peaceful manner, very different from how the rest of your night has been. There's a gas can on the ground which is odd, I mean seriously, it's a gas can in the middle of a park. There looks to be a harbor to the west of you and the hotel is to your east.

You can see a Gas Can, Trees and Leaves here.

>w
Harbor
The harbor you can see the American ship a way off into the difference. It's to far to swim but you see a boat on the beach next to you. As you move toward the boat your hope grows and El Sharaawy sprints towards it. As you reach it you find that there is a major problem, it has no gas. The park is to the east of you. More descriptions coming later. You should probably try combining something with the boat. The part is to the east.

You can see a Gasless Boat (empty) here.

>e
Park
A park. It's quiet and peaceful with not a single angry mob in sight. The leaves on the trees rustle in a peaceful manner, very different from how the rest of your night has been. There's a gas can on the ground which is odd, I mean seriously, it's a gas can in the middle of a park. There looks to be a harbor to the west of you and the hotel is to your east.

You can see a Gas Can, Trees and Leaves here.

>undo
Harbor
[Previous turn undone.]

>undo
Park
[Previous turn undone.]

>take gas
Taken.

>w
Harbor
The harbor you can see the American ship a way off into the difference. It's to far to swim but you see a boat on the beach next to you. As you move toward the boat your hope grows and El Sharaawy sprints towards it. As you reach it you find that there is a major problem, it has no gas. The park is to the east of you. More descriptions coming later. You should probably try combining something with the boat. The part is to the east.

You can see a Gasless Boat (empty) here.

* * *

>take boat
You move the Boat a few feet before realizing it's way to heavy to carry. You decide to drag it along behind you though, just so no one else steals your boat.

* * *

>combine gasless boat with gas can
You fill up the boat with gas. Now with a full tank you and El Sharaawy look at each other and get ready to leave.

>get in boat
You can only get into something free-standing.

>drop boat
Dropped.

>get in boat
You get into the Gasless Boat.

You can feel the safety and Freedom radiating off of the Battleship, only a few more minutes until you're safe and sound.

    *** You have won ***

In that game you scored 1 out of a possible 0, in 20 turns.

Would you like to RESTART, RESTORE a saved game, QUIT or UNDO the last command?

Please give one of the answers above.

Would you like to RESTART, RESTORE a saved game, QUIT or UNDO the last command?

Please give one of the answers above.

Would you like to RESTART, RESTORE a saved game, QUIT or UNDO the last command?

* * *

>ask el about coming with m
There is no reply.

>ask el about coming with me
He looks at you again and decides that you are a trustworthy looking person. "I'm counting on you to get us out of here. You may need this," he says and hands you the key to the Garage Door. Time for you to do your job.

[Your score has just gone up by one point.]

>w
You can't go that way.

* * *

>e
Garage
The stadium garage. There are still tons of cars here, everyone must have just chosen to run instead of trying to drive off. You can see a fancy bus to the west of you and the Garage door probably leading outside to the east of you.

You can see a Garage Door here.

>unlock door with key
You unlock the Garage Door.

* * *

>e
(first opening the Garage Door)

Back Street
A dingy back street, unfitting of the World Cup. By the dim light of the one lamp post you can see multiple trash cans and trash bags lying around. Off in the distance you can hear the Brazillians yelling to each other. The Hotel is to your north and the garage is to the west.

You can see a Garage Door, Trash Cans, Cigarette butts and Bottles of Alcohol here.

>x cans
Looking into the nearest two trash cans you find nothing but trash, what a surprise, but after looking in the third you pull out a vaccum sealed bag with two sets of Grey Fatigues inside like something out of Metal Gear. You give one to El Sharaawy and put yours on.

* * *

>w
Park
A park. It's quiet and peaceful with not a single angry mob in sight. The leaves on the trees rustle in a peaceful manner, very different from how the rest of your night has been. There's a gas can on the ground which is odd, I mean seriously, it's a gas can in the middle of a park. There looks to be a harbor to the west of you and the hotel is to your east.

You can see a Gas Can, Trees and Leaves here.

>take cans
You can't see any such thing.

>take gas
Taken.

* * *

>w
Harbor
The harbor you can see the American ship a way off into the difference. It's to far to swim but you see a boat on the beach next to you. As you move toward the boat your hope grows and El Sharaawy sprints towards it. As you reach it you find that there is a major problem, it has no gas. The park is to the east of you. More descriptions coming later. You should probably try combining something with the boat. The part is to the east.

You can see a Gasless Boat (empty) here.

>take boat
You move the Boat a few feet before realizing it's way to heavy to carry. You decide to drag it along behind you though, just so no one else steals your boat.

>fill gasless boat with gas can
You fill up the boat with gas. Now with a full tank you and El Sharaawy look at each other and get ready to leave.

>get in boat
You get into the Gasless Boat.

You can feel the safety and Freedom radiating off of the Battleship, only a few more minutes until you're safe and sound.

    *** You have won ***

In that game you scored 1 out of a possible 0, in 17 turns.

Would you like to RESTART, RESTORE a saved game, QUIT or UNDO the last command?

* * *

>take bags
That's fixed in place.

* * *

>e
Garage
The stadium garage. There are still tons of cars here, everyone must have just chosen to run instead of trying to drive off. You can see a fancy bus to the west of you and the Garage door probably leading outside to the east of you.

You can see a Garage Door here.

>w
Bus
The Italian team's bus! Worried about the team you rush inside the bus to find it almost completely empty. As you move past the rows of comfortable seats you reach the back of the bus and find a pile of bags on the seats. The garage is to the east of you.

You can see El Sharaawy and a rows of seats (empty) here.

>ask el about come with me
He looks at you again and decides that you are a trustworthy looking person. "I'm counting on you to get us out of here. You may need this," he says and hands you the key to the Garage Door. Time for you to do your job.

[Your score has just gone up by one point.]

* * *

>e
(first opening the Garage Door)

Back Street
A dingy back street, unfitting of the World Cup. By the dim light of the one lamp post you can see multiple trash cans and trash bags lying around. Off in the distance you can hear the Brazillians yelling to each other. The Hotel is to your north and the garage is to the west.

You can see a Garage Door, Trash Cans, Cigarette butts and Bottles of Alcohol here.

>n
Hotel Lobby
The hotel you're staying at, you have a room in one of the floors above. You can see a few Brazilians walking around patroling for Italian supporters like you before they move on, leaving one man to keep watch. You should think this through very carefully before making a move. Or not, but getting to your room would guarantee you some useful stuff. There is a bench, a computer, and some potted plants in the Hotel Lobby. You can see a park to the west of you and the street you just came off of to the east. Your room is above you.

You can see a Brazilian, a bench (empty), a potted plants and a computer here.

An exclamation pops up on the top of the Brazilian's heads as they rush toward you.

    *** You have died ***

In that game you scored 1 out of a possible 0, in 11 turns.

Would you like to RESTART, RESTORE a saved game, QUIT or UNDO the last command?

>undo
Back Street
[Previous turn undone.]

>x cans
Looking into the nearest two trash cans you find nothing but trash, what a surprise, but after looking in the third you pull out a vaccum sealed bag with two sets of Grey Fatigues inside like something out of Metal Gear. You give one to El Sharaawy and put yours on.

* * *

>w
Park
A park. It's quiet and peaceful with not a single angry mob in sight. The leaves on the trees rustle in a peaceful manner, very different from how the rest of your night has been. There's a gas can on the ground which is odd, I mean seriously, it's a gas can in the middle of a park. There looks to be a harbor to the west of you and the hotel is to your east.

You can see a Gas Can, Trees and Leaves here.

>take can
Taken.

>w
Harbor
The harbor you can see the American ship a way off into the difference. It's to far to swim but you see a boat on the beach next to you. As you move toward the boat your hope grows and El Sharaawy sprints towards it. As you reach it you find that there is a major problem, it has no gas. The park is to the east of you. More descriptions coming later. You should probably try combining something with the boat. The part is to the east.

You can see a Gasless Boat (empty) here.

* * *

>take boat
You move the Boat a few feet before realizing it's way to heavy to carry. You decide to drag it along behind you though, just so no one else steals your boat.

>fill gasless boat with gas can
I didn't understand that sentence.

>fill up gasless boat with gas can
You fill up the boat with gas. Now with a full tank you and El Sharaawy look at each other and get ready to leave.

* * *

>ask el about coming with me
He looks at you again and decides that you are a trustworthy looking person. "I'm counting on you to get us out of here. You may need this," he says and hands you the key to the Garage Door. Time for you to do your job.

[Your score has just gone up by one point.]

>e
Garage
The stadium garage. There are still tons of cars here, everyone must have just chosen to run instead of trying to drive off. You can see a fancy bus to the west of you and the Garage door probably leading outside to the east of you.

You can see a Garage Door here.

* * *

>x cans
Looking into the nearest two trash cans you find nothing but trash, what a surprise, but after looking in the third you pull out a vaccum sealed bag with two sets of Grey Fatigues inside like something out of Metal Gear. You give one to El Sharaawy and put yours on.

>w
Garage
The stadium garage. There are still tons of cars here, everyone must have just chosen to run instead of trying to drive off. You can see a fancy bus to the west of you and the Garage door probably leading outside to the east of you.

You can see a Garage Door here.

>e
Back Street
A dingy back street, unfitting of the World Cup. By the dim light of the one lamp post you can see multiple trash cans and trash bags lying around. Off in the distance you can hear the Brazillians yelling to each other. The Hotel is to your north and the garage is to the west.

You can see a Garage Door, Trash Cans, Cigarette butts and Bottles of Alcohol here.

>n
Hotel Lobby
The hotel you're staying at, you have a room in one of the floors above. You can see a few Brazilians walking around patroling for Italian supporters like you before they move on, leaving one man to keep watch. You should think this through very carefully before making a move. Or not, but getting to your room would guarantee you some useful stuff. There is a bench, a computer, and some potted plants in the Hotel Lobby. You can see a park to the west of you and the street you just came off of to the east. Your room is above you.

You can see a Brazilian, a bench (empty), a potted plants and a computer here.

You move quietly around the Hotel Lobby to not be noticed

* * *

>w
Harbor
The harbor you can see the American ship a way off into the difference. It's to far to swim but you see a boat on the beach next to you. As you move toward the boat your hope grows and El Sharaawy sprints towards it. As you reach it you find that there is a major problem, it has no gas. The park is to the east of you. More descriptions coming later. You should probably try combining something with the boat. The part is to the east.

You can see a Gasless Boat (empty) here.

>fill up gasless boat with gas can
You must supply a noun.

>take boat
You move the Boat a few feet before realizing it's way to heavy to carry. You decide to drag it along behind you though, just so no one else steals your boat.

>fill up gasless boat with gas can
You must supply a noun.

* * *

>w
Bus
The Italian team's bus! Worried about the team you rush inside the bus to find it almost completely empty. As you move past the rows of comfortable seats you reach the back of the bus and find a pile of bags on the seats. The garage is to the east of you.

You can see a rows of seats (empty) and Bags here.

>e
Garage
The stadium garage. There are still tons of cars here, everyone must have just chosen to run instead of trying to drive off. You can see a fancy bus to the west of you and the Garage door probably leading outside to the east of you.

You can see a Garage Door here.

>n
Hotel Lobby
The hotel you're staying at, you have a room in one of the floors above. You can see a few Brazilians walking around patroling for Italian supporters like you before they move on, leaving one man to keep watch. You should think this through very carefully before making a move. Or not, but getting to your room would guarantee you some useful stuff. There is a bench, a computer, and some potted plants in the Hotel Lobby. You can see a park to the west of you and the street you just came off of to the east. Your room is above you.

You can see a Brazilian, a bench (empty), a potted plants and a computer here.

An exclamation pops up on the top of the Brazilian's heads as they rush toward you.

    *** You have died ***

In that game you scored 0 out of a possible 0, in 4 turns.

Would you like to RESTART, RESTORE a saved game, QUIT or UNDO the last command?

* * *

>e
Garage
The stadium garage. There are still tons of cars here, everyone must have just chosen to run instead of trying to drive off. You can see a fancy bus to the west of you and the Garage door probably leading outside to the east of you.

You can see a Garage Door here.

>x car right next to you
Cars of everyshape and size are everwhere in this massive parking garage. You don't have time to check all of them out though, who knows when those Brazilians could come back.

>get in ferrari
You can feel the power of this Italian sports car pulze through your veins as you get in. Luckily someone had left the keys in the cupholder so you power her up and drive off into the night, nobody can catch you now.

    *** You have won ***

In that game you scored 0 out of a possible 0, in 5 turns.

Would you like to RESTART, RESTORE a saved game, QUIT or UNDO the last command?

>undo
Garage
[Previous turn undone.]

>l
Garage
The stadium garage. There are still tons of cars here, everyone must have just chosen to run instead of trying to drive off. You can see a fancy bus to the west of you and the Garage door probably leading outside to the east of you.

You can see a Ferrari (empty) and a Garage Door here.

* * *

>n
Garage
The stadium garage. There are still tons of cars here, everyone must have just chosen to run instead of trying to drive off. You can see a fancy bus to the west of you and the Garage door probably leading outside to the east of you.

You can see a Garage Door here.

>n
You can't go that way.

>w
Bus
The Italian team's bus! Worried about the team you rush inside the bus to find it almost completely empty. As you move past the rows of comfortable seats you reach the back of the bus and find a pile of bags on the seats. The garage is to the east of you.

You can see a rows of seats (empty) and Bags here.

* * *

>e
(first opening the Garage Door)
It seems to be locked.

>w
Bus
The Italian team's bus! Worried about the team you rush inside the bus to find it almost completely empty. As you move past the rows of comfortable seats you reach the back of the bus and find a pile of bags on the seats. The garage is to the east of you.

You can see a rows of seats (empty) and Bags here.

>w
You can't go that way.

>take bags
As you move to take a closer look at the bags a man bursts from the pile and lands a solid kick to your abdomen. You stagger backwards and lift your arms to block yourself from another hit. As you get a better look at your assailant you gasp in surprise. It's El Sharaawy, your favorite player on the Italian team. As he realizes you're wearing Italian colors he rushes over to check on you. He explains that when the Brazil fans came charging the rest of the team ran but even though he was the fastest he knew hiding was a better option. You want to leave but you can't just leave him here alone. You have to take him with you but he's very adamant about staying. Time for you to do some fancy talking, maybe Asking him About coming with you would be helpful.

* * *

>e
(first opening the Garage Door)

Back Street
A dingy back street, unfitting of the World Cup. By the dim light of the one lamp post you can see multiple trash cans and trash bags lying around. Off in the distance you can hear the Brazillians yelling to each other. The Hotel is to your north and the garage is to the west.

You can see a Garage Door, Trash Cans, Cigarette butts and Bottles of Alcohol here.

>n
Hotel Lobby
The hotel you're staying at, you have a room in one of the floors above. You can see a few Brazilians walking around patroling for Italian supporters like you before they move on, leaving one man to keep watch. You should think this through very carefully before making a move. Or not, but getting to your room would guarantee you some useful stuff. There is a bench, a computer, and some potted plants in the Hotel Lobby. You can see a park to the west of you and the street you just came off of to the east. Your room is above you.

You can see a Brazilian, a bench (empty), a potted plants and a computer here.

An exclamation pops up on the top of the Brazilian's heads as they rush toward you.

    *** You have died ***

In that game you scored 1 out of a possible 0, in 14 turns.

Would you like to RESTART, RESTORE a saved game, QUIT or UNDO the last command?

>s
Please give one of the answers above.

Would you like to RESTART, RESTORE a saved game, QUIT or UNDO the last command?

* * *

>undo
Back Street
[Previous turn undone.]

>take oooooooooooooooooooooooooo
You can't see any such thing.

>undo
Back Street
[Previous turn undone.]

>restart
Are you sure you want to restart?

* * *

>n
Garage
The stadium garage. There are still tons of cars here, everyone must have just chosen to run instead of trying to drive off. You can see a fancy bus to the west of you and the Garage door probably leading outside to the east of you.

You can see a Garage Door here.

>x
(the Bag)
An Italy booster bag, why would you have anything else. Everything you take will end up in here so there's no need to carry all that weird stuff.

>s
Stadium Concourse
The stadium concourse, you can see the angry mob of Brazilians running off into the distance. Around you there are food kiosks and booths selling booster wear for Brazil, Italy, and FIFA. There's also a trashcan, recycle bin, and trash on the ground. There's a garage to the north of you.

You can see Food, Bottles, FIFA Booster Wear, Brazil Booster Wear, Italy Booster Wear and Trash here.

>x recycle bin
A recycle bin, you can see bottles of different drinks inside. For some reason there seems to be an unopened can of soda inside there's bin as well.

>x soda
A can of Sprite.

>take box
You can't see any such thing.

>l
Stadium Concourse
The stadium concourse, you can see the angry mob of Brazilians running off into the distance. Around you there are food kiosks and booths selling booster wear for Brazil, Italy, and FIFA. There's also a trashcan, recycle bin, and trash on the ground. There's a garage to the north of you.

You can see Can of Soda, Food, Bottles, FIFA Booster Wear, Brazil Booster Wear, Italy Booster Wear and Trash here.

>x trash
Scraps of paper dishes, paper pamphlets, and other bits of trash litter the ground.

>x food
Half eaten dishes, pretty disgusting looking but it's up to you if you want it.

>x bottles
Empty sticky bottles of drinks.

>x fifa booster
FIFA booster wear that they're selling. Most of it is just clothes advertising the fact that it's the FIFA World Cup. There are some nice shirts in there though.

>x brazil booster
Disgusting, dirty Brazilian Booster Wear. You'd burn it but you don't have the time or tools to do that.

>x italy booster
Beautiful, amazing Italian Booster Wear. You can never have to much of this.

>x trash
Scraps of paper dishes, paper pamphlets, and other bits of trash litter the ground.

>x trashcan
A trashcan with trash inside, duh. Among the trash you can see food, cups, and some pamphlets for the game.

>l
Stadium Concourse
The stadium concourse, you can see the angry mob of Brazilians running off into the distance. Around you there are food kiosks and booths selling booster wear for Brazil, Italy, and FIFA. There's also a trashcan, recycle bin, and trash on the ground. There's a garage to the north of you.

You can see Can of Soda, Food, Bottles, FIFA Booster Wear, Brazil Booster Wear, Italy Booster Wear and Trash here.

>x angry mob
The home fans" little mob. Who are you kidding, that things huge. It looks like every Brazil fan in the stadium joined to make that mob.

* * *

>x recycle
A recycle bin, you can see bottles of different drinks inside. For some reason there seems to be an unopened can of soda inside there's bin as well.

>x soda
A can of Sprite. You would drink it but it's warm and covered in a mysterious liquid. Lets wait till later.

>take soda
You put the Sprite in your bag for later. You may need it more then.

>take box
Taken.

>e
You can't go that way.

>w
You can't go that way.

>n
Garage
The stadium garage. There are still tons of cars here, everyone must have just chosen to run instead of trying to drive off. You can see a fancy bus to the west of you and the Garage door probably leading outside to the east of you.

You can see a Garage Door here.

* * *

>ask el about come with you
There is no reply.

>ask el about come with me
He looks at you again and decides that you are a trustworthy looking person. "I'm counting on you to get us out of here. You may need this," he says and hands you the key to the Garage Door. Time for you to do your job.

[Your score has just gone up by one point.]

* * *

>e
Garage
The stadium garage. There are still tons of cars here, everyone must have just chosen to run instead of trying to drive off. You can see a fancy bus to the west of you and the Garage door probably leading outside to the east of you.

You can see a Garage Door here.

>unlock door
What do you want to unlock the Garage Door with?

>with key
You can't see any such thing.

>unlock door with key
You unlock the Garage Door.

* * *

>e
(first opening the Garage Door)

Back Street
A dingy back street, unfitting of the World Cup. By the dim light of the one lamp post you can see multiple trash cans and trash bags lying around. Off in the distance you can hear the Brazillians yelling to each other. The Hotel is to your north and the garage is to the west.

You can see a Garage Door, Trash Cans, Cigarette butts and Bottles of Alcohol here.

>n
Hotel Lobby
The hotel you're staying at, you have a room in one of the floors above. You can see a few Brazilians walking around patroling for Italian supporters like you before they move on, leaving one man to keep watch. You should think this through very carefully before making a move. Or not, but getting to your room would guarantee you some useful stuff. There is a bench, a computer, and some potted plants in the Hotel Lobby. You can see a park to the west of you and the street you just came off of to the east. Your room is above you.

You can see a Brazilian, a bench (empty), a potted plants and a computer here.

Just like Snake you creep around the Brazilians hiding in your box. As soon as you circle behind them you ditch the box pull out your pistol and let freedom ring on these poor souls before continuing on into the night.
An exclamation pops up on the top of the Brazilian's heads as they rush toward you.

    *** You have died ***

In that game you scored 1 out of a possible 0, in 15 turns.

Would you like to RESTART, RESTORE a saved game, QUIT or UNDO the last command?

* * *

>x brazilians
The home fans" little mob. Who are you kidding, that things huge. It looks like every Brazil fan in the stadium joined to make that mob.

>x kiosk
You can't see any such thing.

>x booths
You can't see any such thing.

>x brazil
Disgusting, dirty Brazilian Booster Wear. You'd burn it but you don't have the time or tools to do that.

>x bottles
Empty sticky bottles of drinks.

>take bottles
[Your score has just gone up by one point.]

>x trash
Scraps of paper dishes, paper pamphlets, and other bits of trash litter the ground.

>take trash
Taken.

>take fifa
[Your score has just gone up by one point.]

>take brazil
You will not dirty your hands by touching that filth.

>take italky
You can't see any such thing.

>take italy
[Your score has just gone up by one point.]

>x trashcan
A trashcan with trash inside, duh. Among the trash you can see food, cups, and some pamphlets for the game.

>x pamphlets
You can't see any such thing.

>x food
You can't see any such thing.

>x cups
You can't see any such thing.

>l
Stadium Concourse
The stadium concourse, you can see the angry mob of Brazilians running off into the distance. Around you there are food kiosks and booths selling booster wear for Brazil, Italy, and FIFA. There's also a trashcan, recycle bin, and trash on the ground. There's a garage to the north of you.

You can see Brazil Booster Wear here.

>x recycle bin
A recycle bin, you can see bottles of different drinks inside. For some reason there seems to be an unopened can of soda inside the bin as well.

>x soda
A can of Sprite.

>take soda
You put the Sprite in your bag for later. You may need it more then.

>x bottles
Empty sticky bottles of drinks.

>take bottles
You already have that.

>n
Garage
The stadium garage. There are still tons of cars here, everyone must have just chosen to run instead of trying to drive off. You can see a fancy bus to the east of you and the Garage door probably leading outside to the west of you. More descriptions later.

You can see a Garage Door here.

>x cars
Cars of everyshape and size are everwhere in this massive parking garage. You don't have time to check all of them out though, who knows when those Brazilians could come back.

>e
(first opening the Garage Door)
It seems to be locked.

>e
(first opening the Garage Door)
It seems to be locked.