The final game of the Fifa World Cup 2014 has just finished. Italy has just beaten Brazil and all of the Italy fans are as happy as a kid in a candy shop and all that candy is free. As an Italy fan you are no exception and the body paint covering your head and torso seems to shine in the lights of the stadium. However the home fans can be catergorized as nothing less than a furious angry mob. As the home fans start charging over to your side of the stadium you and the rest of the Italy fans start running for your lives. As you peer down at the field you can see the Italian soccer team also being chased down by a bunch of angry Brazillians and you can only hope that everyone is able to escape without injury. No matter how big this stadium is seeing that many people charging is a sight that would make any grown man tremble. After hiding in the bathroom for a little bit you walk out into the Concouse and see the angry mob of Brazillians running off into the street.

Viva L'Italia
An Interactive Fiction by $wag Meister Cody Martinson The Maximum score is 4
Release 1 / Serial number 140225 / Inform 7 build 6G60 (I6/v6.32 lib 6/12N) SD

Stadium Concourse
The stadium concourse, you can see the angry mob of Brazillians running off into the distance. Around you there are food kiosks and booths selling booster wear for Brazil, Italy, and FIFA. There's also a trashcan, recycle bin, and trash on the ground. There's a garage to the north of you.

You can see Bottles, FIFA Booster Wear, Brazil Booster Wear, Italy Booster Wear and Trash here.

>x
(the Bag)
An Italy booster bag, why would you have anything else. Everything you take will end up in here so there's no need to carry all that wierd stuff.

>i
You are carrying:
  a Bag

* * *

>x recycle bing
I only understood you as far as wanting to examine the Recycle Bin.

>x recycle
A recycle bin, you can see bottles of different drinks inside. For some reason there seems to be an unopened can of soda inside the bin as well.

>x recycle
A recycle bin, you can see bottles of different drinks inside. For some reason there seems to be an unopened can of soda inside the bin as well.

>take soda
[Your score has just gone up by one point.]

>x soda
A can of Sprite. You put it in your bag for later.

* * *

>take brazil
You will not dirty your hands by touching that filth.

* * *

>take fifa
[Your score has just gone up by one point.]

* * *

>north
Garage
The stadium garage. There are still tons of cars here, everyone must have just chosen to run instead of trying to drive off. You can see a fancy bus to the east of you and the street that runs behind the stadium to the west of you.

* * *

>x El Sharaawt
You can't see any such thing.

* * *

>n
Garage
The stadium garage. There are still tons of cars here, everyone must have just chosen to run instead of trying to drive off. You can see a fancy bus to the east of you and the street that runs behind the stadium to the west of you.

>w
Bus
The Italian team's bus! Worried about the team you rush inside the bus to find it almost completely empty. As you move past the rows of comfortable seats you reach the back of the bus and find a pile of bags on the seats.

You can see Bags and El Sharaawy here.

>x el
Your favorite soccer player in the world. Not only is he super fast but he has a sick mohawk.